1111111111
10C000C0E1
10X0011001
100X000001
100C000111
1000X00001
1C01110011
100001X001
1P00X00001
1111111111
