1111111111
1PC00000E1
10X0011001
100X000001
10E00C0111
1000X00C01
1001110011
100C01X001
1000X00001
1111111111
